#####:@:############
#....:::...........#
#....:::...........#
#....:::.%.........#
#..%.:::...........#
#....:::...........#
#....:::.%.........#
#....:::...........#
#..%.:::...........#
#....:::...........#
#....:::..%........#
#....:::...........#
#....:::::::::::::::
#..%.:::::::::::::::
#....:::::::::::::::
#......%......%....#
#..................#
#..................#
#..................#
####################
